111111111111111111111
1C000C000C00000000001
1000CPC00000000000001
10000C000000000000001
1C000E000C00000000001
10000C000000000000001
1C000E000C00000000001
10000C000000000000001
1C000E000C00000000001
10000C000000000000001
1C000E000C00000000001
10000C000000000000001
1C000E000C00000000001
10000C000000000000001
1C000E000C00000000001
111111111111111111111
