11111111111
1C000C000C1
1000CPC00011
10000C00001
1C000E000C1
11111111111
