11111111111
1C000C000C1
1000CPC0001
10N00C00001
1C000E000C1
11111011111
