11111111111
1C000C000C1
1000CPC0001
10000C00001
1C0000000C1
11111111111
