11111111111
1C000C000C1
1000C0C0001
10000C00001
1C000E000C1
11111111111
