11111111111
1C000E000C1
1000EPE0001
10000E00001
1C000E000C1
11111111111
