1111111111111111111111
1C000C000C000000000001
1000CPC000000000000001
10000C0000000000000001
1C000E000C000000000001
1111111111111111111111
