111111111111111111111111111111111111111111111111111111111111111111
1C000C000C0000000000000C000C000C0000000000000C000C000C000000000001
1000CPC00000000000000000C0C00000000000000000C0C0000000000000000001
10000C0000000000000000000C0000000000000000000C00000000000000000001
1C000E000C00000000000C000E000C00000000000C000E000C0000000000000001
111111111111111111111111111111111111111111111111111111111111111111
