11111111111
1C0A0C0A0C1
1000CPC0001
10A00C00001
1C000E00AC1
11111111111
