11111111111
1C0A0C0A0C1
1000CPC0001
10A00C0A001
1C000E000C1
11111111111
